####################################
#                                  #
#                                  #
#                                  #
#                                  #
#         ---                      #
#                                  #
#                   ___            #
#                   ---            #
####################################